00  00  00  00  00  00  00  00  00  00  00  00  00  00  00  00  00  00  00  00  00  00  00  00  00  00  00  00  00  00  00  00  00  00  00  00  00  00  00  00  00
00  00  00  00  00  00  00  00  00  00  00  00  00  00  00  00  00  00  00  00  00  00  00  00  00  00  00  00  00  00  00  00  00  00  00  00  00  00  00  00  00
00  00  00  00  00  00  00  00  00  00  00  00  00  00  00  00  00  00  00  00  00  00  00  00  00  00  00  00  00  00  00  00  00  00  00  00  00  00  00  00  00
00  00  00  00  00  00  00  00  00  00  00  00  00  00  00  00  00  00  00  00  00  00  00  00  00  00  00  00  00  00  00  00  00  00  00  00  00  00  00  00  00
00  00  00  00  00  00  00  00  00  00  00  00  00  00  00  00  00  00  00  00  00  00  00  00  00  00  00  00  00  00  00  00  00  00  00  00  00  00  00  00  00
00  00  00  00  00  00  00  00  00  00  00  00  00  00  00  00  00  00  00  00  00  00  00  00  00  00  00  00  00  00  00  00  00  00  00  00  00  00  00  00  00
00  00  00  00  00  00  00  00  00  00  00  00  00  00  00  00  00  00  00  00  00  00  00  00  00  00  00  00  00  00  00  00  00  00  00  00  00  00  00  00  00
00  00  00  00  00  00  00  00  00  00  00  00  00  00  00  00  00  00  00  00  00  00  00  00  00  00  00  00  00  00  00  00  00  00  00  00  00  00  00  00  00
00  00  00  00  00  00  00  00  00  00  00  00  00  00  00  00  00  00  00  00  00  00  00  00  00  00  00  00  00  00  00  00  00  00  00  00  00  00  00  00  00
00  00  00  00  00  00  00  00  00  00  00  01  01  01  01  01  01  01  01  01  01  01  01  01  01  01  01  01  01  01  00  00  00  00  00  00  00  00  00  00  00
00  00  00  00  00  00  00  00  00  00  00  01  02  02  02  02  02  02  02  02  02  02  02  02  02  02  02  02  02  01  00  00  00  00  00  00  00  00  00  00  00
00  00  00  00  00  00  00  00  00  00  00  01  02  02  02  02  02  02  02  02  02  02  02  02  02  02  02  02  02  01  00  00  00  00  00  00  00  00  00  00  00
00  00  00  00  00  00  00  00  00  00  00  01  02  02  03  04  04  04  04  04  04  04  04  04  04  04  03  02  02  01  00  00  00  00  00  00  00  00  00  00  00
00  00  00  00  00  00  00  00  00  00  00  01  02  02  03  03  03  03  03  03  01  03  03  03  03  03  03  02  02  01  00  00  00  00  00  00  00  00  00  00  00
00  00  00  00  00  00  00  00  00  00  00  01  02  02  03  04  03  03  03  05  01  03  03  03  03  04  03  02  02  01  00  00  00  00  00  00  00  00  00  00  00
00  00  00  00  00  00  00  00  00  00  00  01  02  02  01  01  01  01  01  01  01  01  01  01  01  01  01  02  02  01  00  00  00  00  00  00  00  00  00  00  00
00  00  00  00  00  00  00  00  00  00  00  01  02  02  03  04  03  05  03  03  01  03  03  03  05  04  03  02  02  01  00  00  00  00  00  00  00  00  00  00  00
00  00  00  00  00  00  00  00  00  00  00  01  02  02  03  03  03  03  03  03  01  03  03  03  03  03  03  02  02  01  00  00  00  00  00  00  00  00  00  00  00
00  00  00  00  00  00  00  00  00  00  00  01  02  02  03  04  04  04  04  04  04  04  04  04  04  04  03  02  02  01  00  00  00  00  00  00  00  00  00  00  00
00  00  00  00  00  00  00  00  00  00  00  01  02  02  02  02  02  02  02  02  02  02  02  02  02  02  02  02  02  01  00  00  00  00  00  00  00  00  00  00  00
00  00  00  00  00  00  00  00  00  00  00  01  02  02  02  02  02  02  02  02  02  02  02  02  02  02  02  02  02  01  00  00  00  00  00  00  00  00  00  00  00
00  00  00  00  00  00  00  00  00  00  00  01  03  03  03  03  03  03  03  03  03  03  03  03  03  03  03  03  03  01  00  00  00  00  00  00  00  00  00  00  00
00  00  00  00  00  00  00  00  00  00  00  01  01  01  01  01  01  01  01  01  01  01  01  01  01  01  01  01  01  01  00  00  00  00  00  00  00  00  00  00  00
00  00  00  00  00  00  00  00  00  00  00  01  02  02  02  02  02  02  02  02  02  02  02  02  02  02  02  02  02  01  00  00  00  00  00  00  00  00  00  00  00
00  00  00  00  00  00  00  00  00  00  00  01  02  02  02  02  02  02  02  02  02  02  02  02  02  02  02  02  02  01  00  00  00  00  00  00  00  00  00  00  00
00  00  00  00  00  00  00  00  00  00  00  01  02  02  03  04  04  04  04  04  04  04  04  04  04  04  03  02  02  01  00  00  00  00  00  00  00  00  00  00  00
00  00  00  00  00  00  00  00  00  00  00  01  02  02  03  03  03  03  03  03  01  03  03  03  03  03  03  02  02  01  00  00  00  00  00  00  00  00  00  00  00
00  00  00  00  00  00  00  00  00  00  00  01  02  02  03  04  03  03  03  05  01  03  03  03  03  04  03  02  02  01  00  00  00  00  00  00  00  00  00  00  00
00  00  00  00  00  00  00  00  00  00  00  01  02  02  01  01  01  01  01  01  01  01  01  01  01  01  01  02  02  01  00  00  00  00  00  00  00  00  00  00  00
00  00  00  00  00  00  00  00  00  00  00  01  02  02  03  04  03  05  03  03  01  03  03  03  05  04  03  02  02  01  00  00  00  00  00  00  00  00  00  00  00
00  00  00  00  00  00  00  00  00  00  00  01  02  02  03  03  03  03  03  03  01  03  03  03  03  03  03  02  02  01  00  00  00  00  00  00  00  00  00  00  00
00  00  00  00  00  00  00  00  00  00  00  01  02  02  03  04  04  04  04  04  04  04  04  04  04  04  03  02  02  01  00  00  00  00  00  00  00  00  00  00  00
00  00  00  00  00  00  00  00  00  00  00  01  02  02  02  02  02  02  02  02  02  02  02  02  02  02  02  02  02  01  00  00  00  00  00  00  00  00  00  00  00
00  00  00  00  00  00  00  00  00  00  00  01  02  02  02  02  02  02  02  02  02  02  02  02  02  02  02  02  02  01  00  00  00  00  00  00  00  00  00  00  00
00  00  00  00  00  00  00  00  00  00  00  01  01  01  01  01  01  01  01  01  01  01  01  01  01  01  01  01  01  01  00  00  00  00  00  00  00  00  00  00  00
00  00  00  00  00  00  00  00  00  00  00  00  00  00  00  00  00  00  00  00  00  00  00  00  00  00  00  00  00  00  00  00  00  00  00  00  00  00  00  00  00
00  00  00  00  00  00  00  00  00  00  00  00  00  00  00  00  00  00  00  00  00  00  00  00  00  00  00  00  00  00  00  00  00  00  00  00  00  00  00  00  00
00  00  00  00  00  00  00  00  00  00  00  00  00  00  00  00  00  00  00  00  00  00  00  00  00  00  00  00  00  00  00  00  00  00  00  00  00  00  00  00  00
00  00  00  00  00  00  00  00  00  00  00  00  00  00  00  00  00  00  00  00  00  00  00  00  00  00  00  00  00  00  00  00  00  00  00  00  00  00  00  00  00
00  00  00  00  00  00  00  00  00  00  00  00  00  00  00  00  00  00  00  00  00  00  00  00  00  00  00  00  00  00  00  00  00  00  00  00  00  00  00  00  00
00  00  00  00  00  00  00  00  00  00  00  00  00  00  00  00  00  00  00  00  00  00  00  00  00  00  00  00  00  00  00  00  00  00  00  00  00  00  00  00  00
00  00  00  00  00  00  00  00  00  00  00  00  00  00  00  00  00  00  00  00  00  00  00  00  00  00  00  00  00  00  00  00  00  00  00  00  00  00  00  00  00
00  00  00  00  00  00  00  00  00  00  00  00  00  00  00  00  00  00  00  00  00  00  00  00  00  00  00  00  00  00  00  00  00  00  00  00  00  00  00  00  00
00  00  00  00  00  00  00  00  00  00  00  00  00  00  00  00  00  00  00  00  00  00  00  00  00  00  00  00  00  00  00  00  00  00  00  00  00  00  00  00  00