00  00  00  00  00  00  00  00  00  00  00  00  00  00  00  00  00  00  00  00  00  00  00  00  00  00  00  00  00  00  00  00  00  00  00  00  00  00  00  00  00
00  00  00  00  00  00  00  00  00  00  00  00  00  00  00  00  00  00  00  00  00  00  00  00  00  00  00  00  00  00  00  00  00  00  00  00  00  00  00  00  00
00  00  00  00  00  00  00  00  00  00  00  00  00  00  00  00  00  00  00  00  00  00  00  00  00  00  00  00  00  00  00  00  00  00  00  00  00  00  00  00  00
00  00  00  00  00  00  00  00  00  00  00  00  00  00  00  00  00  00  00  00  00  00  00  00  00  00  00  00  00  00  00  00  00  00  00  00  00  00  00  00  00
00  00  00  00  00  00  00  00  00  00  00  00  00  00  00  00  00  00  00  00  00  00  00  00  00  00  00  00  00  00  00  00  00  00  00  00  00  00  00  00  00
00  00  00  00  00  00  00  00  00  00  00  00  00  00  00  00  00  00  00  00  00  00  00  00  00  00  00  00  00  00  00  00  00  00  00  00  00  00  00  00  00
00  00  00  00  00  00  00  00  00  00  00  00  00  00  00  00  00  00  00  00  00  00  00  00  00  00  00  00  00  00  00  00  00  00  00  00  00  00  00  00  00
00  00  00  00  00  00  00  00  00  00  00  00  00  00  00  00  00  00  00  00  00  00  00  00  00  00  00  00  00  00  00  00  00  00  00  00  00  00  00  00  00
00  00  00  00  00  00  00  00  00  00  00  08  08  08  08  08  08  08  08  08  08  08  08  08  08  08  08  08  08  08  00  00  00  00  00  00  00  00  00  00  00
00  00  00  00  00  00  00  00  00  00  07  01  01  01  01  01  01  01  01  01  01  01  01  01  01  01  01  01  01  01  06  00  00  00  00  00  00  00  00  00  00
00  00  00  00  00  00  00  00  00  00  07  01  02  02  02  02  02  02  02  02  02  02  02  02  02  02  02  02  02  01  06  00  00  00  00  00  00  00  00  00  00
00  00  00  00  00  00  00  00  00  00  07  01  02  02  02  02  02  02  02  02  02  02  02  02  02  02  02  02  02  01  06  00  00  00  00  00  00  00  00  00  00
00  00  00  00  00  00  00  00  00  00  07  01  02  02  03  04  04  04  04  04  04  04  04  04  04  04  03  02  02  01  06  00  00  00  00  00  00  00  00  00  00
00  00  00  00  00  00  00  00  00  00  07  01  02  02  03  03  03  03  03  03  01  03  03  03  03  04  03  02  02  01  06  00  00  00  00  00  00  00  00  00  00
00  00  00  00  00  00  00  00  00  00  07  01  02  02  03  04  03  03  03  05  01  03  03  03  03  03  03  02  02  01  06  00  00  00  00  00  00  00  00  00  00
00  00  00  00  00  00  00  00  00  00  07  01  02  02  01  01  01  01  01  01  01  01  01  01  01  01  01  02  02  01  06  00  00  00  00  00  00  00  00  00  00
00  00  00  00  00  00  00  00  00  00  07  01  02  02  03  03  03  05  03  03  01  03  03  03  05  04  03  02  02  01  06  00  00  00  00  00  00  00  00  00  00
00  00  00  00  00  00  00  00  00  00  07  01  02  02  03  03  03  03  03  03  01  03  03  03  03  03  03  02  02  01  06  00  00  00  00  00  00  00  00  00  00
00  00  00  00  00  00  00  00  00  00  07  01  02  02  03  04  04  04  04  04  04  04  04  04  04  04  03  02  02  01  06  00  00  00  00  00  00  00  00  00  00
00  00  00  00  00  00  00  00  00  00  07  01  02  02  02  02  02  02  02  02  02  02  02  02  02  02  02  02  02  01  06  00  00  00  00  00  00  00  00  00  00
00  00  00  00  00  00  00  00  00  00  07  01  02  02  02  02  02  02  02  02  02  02  02  02  02  02  02  02  02  01  06  00  00  00  00  00  00  00  00  00  00
00  00  00  00  00  00  00  00  00  00  07  01  03  03  03  03  03  03  03  03  03  03  03  03  03  03  03  03  03  01  06  00  00  00  00  00  00  00  00  00  00
00  00  00  00  00  00  00  00  00  00  07  01  01  01  01  01  01  01  01  01  01  01  01  01  01  01  01  01  01  01  06  00  00  00  00  00  00  00  00  00  00
00  00  00  00  00  00  00  00  00  00  07  01  02  02  02  02  02  02  02  02  02  02  02  02  02  02  02  02  02  01  06  00  00  00  00  00  00  00  00  00  00
00  00  00  00  00  00  00  00  00  00  07  01  02  02  02  02  02  02  02  02  02  02  02  02  02  02  02  02  02  01  06  00  00  00  00  00  00  00  00  00  00
00  00  00  00  00  00  00  00  00  00  07  01  02  02  03  03  04  04  04  04  04  04  04  04  04  04  04  02  02  01  06  00  00  00  00  00  00  00  00  00  00
00  00  00  00  00  00  00  00  00  00  07  01  02  02  03  04  03  03  03  03  01  03  03  03  03  03  03  02  02  01  06  00  00  00  00  00  00  00  00  00  00
00  00  00  00  00  00  00  00  00  00  07  01  02  02  03  03  03  03  03  05  01  03  03  03  03  03  03  02  02  01  06  00  00  00  00  00  00  00  00  00  00
00  00  00  00  00  00  00  00  00  00  07  01  02  02  01  01  01  01  01  01  01  01  01  01  01  01  01  02  02  01  06  00  00  00  00  00  00  00  00  00  00
00  00  00  00  00  00  00  00  00  00  07  01  02  02  03  04  03  05  03  03  01  03  03  03  05  03  03  02  02  01  06  00  00  00  00  00  00  00  00  00  00
00  00  00  00  00  00  00  00  00  00  07  01  02  02  03  03  03  03  03  03  01  03  03  03  03  03  03  02  02  01  06  00  00  00  00  00  00  00  00  00  00
00  00  00  00  00  00  00  00  00  00  07  01  02  02  03  04  04  04  04  04  04  04  04  04  04  04  03  02  02  01  06  00  00  00  00  00  00  00  00  00  00
00  00  00  00  00  00  00  00  00  00  07  01  02  02  02  02  02  02  02  02  02  02  02  02  02  02  02  02  02  01  06  00  00  00  00  00  00  00  00  00  00
00  00  00  00  00  00  00  00  00  00  07  01  02  02  02  02  02  02  02  02  02  02  02  02  02  02  02  02  02  01  06  00  00  00  00  00  00  00  00  00  00
00  00  00  00  00  00  00  00  00  00  07  01  01  01  01  01  01  01  01  01  01  01  01  01  01  01  01  01  01  01  06  00  00  00  00  00  00  00  00  00  00
00  00  00  00  00  00  00  00  00  00  00  09  09  09  09  09  09  09  09  09  09  09  09  09  09  09  09  09  09  09  00  00  00  00  00  00  00  00  00  00  00
00  00  00  00  00  00  00  00  00  00  00  00  00  00  00  00  00  00  00  00  00  00  00  00  00  00  00  00  00  00  00  00  00  00  00  00  00  00  00  00  00
00  00  00  00  00  00  00  00  00  00  00  00  00  00  00  00  00  00  00  00  00  00  00  00  00  00  00  00  00  00  00  00  00  00  00  00  00  00  00  00  00
00  00  00  00  00  00  00  00  00  00  00  00  00  00  00  00  00  00  00  00  00  00  00  00  00  00  00  00  00  00  00  00  00  00  00  00  00  00  00  00  00
00  00  00  00  00  00  00  00  00  00  00  00  00  00  00  00  00  00  00  00  00  00  00  00  00  00  00  00  00  00  00  00  00  00  00  00  00  00  00  00  00
00  00  00  00  00  00  00  00  00  00  00  00  00  00  00  00  00  00  00  00  00  00  00  00  00  00  00  00  00  00  00  00  00  00  00  00  00  00  00  00  00
00  00  00  00  00  00  00  00  00  00  00  00  00  00  00  00  00  00  00  00  00  00  00  00  00  00  00  00  00  00  00  00  00  00  00  00  00  00  00  00  00
00  00  00  00  00  00  00  00  00  00  00  00  00  00  00  00  00  00  00  00  00  00  00  00  00  00  00  00  00  00  00  00  00  00  00  00  00  00  00  00  00
00  00  00  00  00  00  00  00  00  00  00  00  00  00  00  00  00  00  00  00  00  00  00  00  00  00  00  00  00  00  00  00  00  00  00  00  00  00  00  00  00