00  00  00  00  00  00  00  00  00  00  00  00  00  00  00  00  00  00  00  00  00  00  00  00  00  00  00  00  00  00  00  00  00  00  00  00  00  00  00  00  00
00  00  00  00  00  00  00  00  00  00  00  00  00  00  00  00  00  00  00  00  00  00  00  00  00  00  00  00  00  00  00  00  00  00  00  00  00  00  00  00  00
00  00  00  00  00  00  00  00  00  00  00  00  00  00  00  00  00  00  00  00  00  00  00  00  00  00  00  00  00  00  00  00  00  00  00  00  00  00  00  00  00
00  00  00  00  00  00  00  00  00  00  00  00  00  00  00  00  00  00  00  00  00  00  00  00  00  00  00  00  00  00  00  00  00  00  00  00  00  00  00  00  00
00  00  00  00  00  00  00  00  00  00  00  00  00  00  00  00  00  00  00  00  00  00  00  00  00  00  00  00  00  00  00  00  00  00  00  00  00  00  00  00  00
00  00  00  00  00  00  00  00  00  00  00  00  00  00  00  00  00  00  00  00  00  00  00  00  00  00  00  00  00  00  00  00  00  00  00  00  00  00  00  00  00
00  00  00  00  00  00  00  00  00  00  00  00  00  00  00  00  00  00  00  00  00  00  00  00  00  00  00  00  00  00  00  00  00  00  00  00  00  00  00  00  00
00  00  00  00  00  00  00  00  00  00  00  00  00  00  00  00  00  00  00  00  00  00  00  00  00  00  00  00  00  00  00  00  00  00  00  00  00  00  00  00  00
00  00  00  00  00  00  00  00  00  00  00  03  03  03  03  03  03  03  03  03  03  03  03  03  03  03  03  03  03  03  00  00  00  00  00  00  00  00  00  00  00
00  00  00  00  00  00  00  00  00  00  02  05  05  05  05  05  05  05  05  05  05  05  05  05  05  05  05  05  05  05  01  00  00  00  00  00  00  00  00  00  00
00  00  00  00  00  00  00  00  00  00  02  05  07  06  08  08  08  08  08  08  08  08  08  08  08  08  08  07  06  05  01  00  00  00  00  00  00  00  00  00  00
00  00  00  00  00  00  00  00  00  00  02  05  07  06  09  09  09  09  09  09  09  09  09  09  09  09  09  07  06  05  01  00  00  00  00  00  00  00  00  00  00
00  00  00  00  00  00  00  00  00  00  02  05  07  06  10  11  11  11  11  11  11  11  11  11  11  11  10  07  06  05  01  00  00  00  00  00  00  00  00  00  00
00  00  00  00  00  00  00  00  00  00  02  05  07  06  10  11  10  10  10  10  05  10  10  10  10  11  10  07  06  05  01  00  00  00  00  00  00  00  00  00  00
00  00  00  00  00  00  00  00  00  00  02  05  07  06  10  10  10  10  10  12  05  10  10  10  10  10  10  07  06  05  01  00  00  00  00  00  00  00  00  00  00
00  00  00  00  00  00  00  00  00  00  02  05  07  06  10  05  05  05  05  05  05  05  05  05  05  05  10  07  06  05  01  00  00  00  00  00  00  00  00  00  00
00  00  00  00  00  00  00  00  00  00  02  05  07  06  10  10  10  10  10  10  05  10  10  10  12  11  10  07  06  05  01  00  00  00  00  00  00  00  00  00  00
00  00  00  00  00  00  00  00  00  00  02  05  07  06  10  10  10  12  10  10  05  10  10  10  10  10  10  07  06  05  01  00  00  00  00  00  00  00  00  00  00
00  00  00  00  00  00  00  00  00  00  02  05  07  06  10  11  11  11  11  11  11  11  11  11  11  11  10  07  06  05  01  00  00  00  00  00  00  00  00  00  00
00  00  00  00  00  00  00  00  00  00  02  05  07  06  08  08  08  08  08  08  08  08  08  08  08  08  08  07  06  05  01  00  00  00  00  00  00  00  00  00  00
00  00  00  00  00  00  00  00  00  00  02  05  07  06  09  09  09  09  09  09  09  09  09  09  09  09  09  07  06  05  01  00  00  00  00  00  00  00  00  00  00
00  00  00  00  00  00  00  00  00  00  02  05  07  06  11  11  11  11  11  11  11  11  11  11  11  11  11  07  06  05  01  00  00  00  00  00  00  00  00  00  00
00  00  00  00  00  00  00  00  00  00  02  05  07  06  11  11  11  11  11  11  11  11  11  11  11  11  11  07  06  05  01  00  00  00  00  00  00  00  00  00  00
00  00  00  00  00  00  00  00  00  00  02  05  07  06  08  08  08  08  08  08  08  08  08  08  08  08  08  07  06  05  01  00  00  00  00  00  00  00  00  00  00
00  00  00  00  00  00  00  00  00  00  02  05  07  06  09  09  09  09  09  09  09  09  09  09  09  09  09  07  06  05  01  00  00  00  00  00  00  00  00  00  00
00  00  00  00  00  00  00  00  00  00  02  05  07  06  10  11  11  11  11  11  11  11  11  11  11  11  11  07  06  05  01  00  00  00  00  00  00  00  00  00  00
00  00  00  00  00  00  00  00  00  00  02  05  07  06  10  11  10  10  10  10  05  10  10  10  10  10  10  07  06  05  01  00  00  00  00  00  00  00  00  00  00
00  00  00  00  00  00  00  00  00  00  02  05  07  06  10  10  10  10  10  12  05  10  10  10  10  10  10  07  06  05  01  00  00  00  00  00  00  00  00  00  00
00  00  00  00  00  00  00  00  00  00  02  05  07  06  10  05  05  05  05  05  05  05  05  05  05  05  10  07  06  05  01  00  00  00  00  00  00  00  00  00  00
00  00  00  00  00  00  00  00  00  00  02  05  07  06  10  11  10  10  10  10  05  10  10  10  10  10  10  07  06  05  01  00  00  00  00  00  00  00  00  00  00
00  00  00  00  00  00  00  00  00  00  02  05  07  06  10  10  12  10  10  10  05  10  10  12  10  10  10  07  06  05  01  00  00  00  00  00  00  00  00  00  00
00  00  00  00  00  00  00  00  00  00  02  05  07  06  10  11  11  11  11  11  11  11  11  11  11  11  10  07  06  05  01  00  00  00  00  00  00  00  00  00  00
00  00  00  00  00  00  00  00  00  00  02  05  07  06  08  08  08  08  08  08  08  08  08  08  08  08  08  07  06  05  01  00  00  00  00  00  00  00  00  00  00
00  00  00  00  00  00  00  00  00  00  02  05  07  06  09  09  09  09  09  09  09  09  09  09  09  09  09  07  06  05  01  00  00  00  00  00  00  00  00  00  00
00  00  00  00  00  00  00  00  00  00  02  05  05  05  05  05  05  05  05  05  05  05  05  05  05  05  05  05  05  05  01  00  00  00  00  00  00  00  00  00  00
00  00  00  00  00  00  00  00  00  00  00  04  04  04  04  04  04  04  04  04  04  04  04  04  04  04  04  04  04  04  00  00  00  00  00  00  00  00  00  00  00
00  00  00  00  00  00  00  00  00  00  00  00  00  00  00  00  00  00  00  00  00  00  00  00  00  00  00  00  00  00  00  00  00  00  00  00  00  00  00  00  00
00  00  00  00  00  00  00  00  00  00  00  00  00  00  00  00  00  00  00  00  00  00  00  00  00  00  00  00  00  00  00  00  00  00  00  00  00  00  00  00  00
00  00  00  00  00  00  00  00  00  00  00  00  00  00  00  00  00  00  00  00  00  00  00  00  00  00  00  00  00  00  00  00  00  00  00  00  00  00  00  00  00
00  00  00  00  00  00  00  00  00  00  00  00  00  00  00  00  00  00  00  00  00  00  00  00  00  00  00  00  00  00  00  00  00  00  00  00  00  00  00  00  00
00  00  00  00  00  00  00  00  00  00  00  00  00  00  00  00  00  00  00  00  00  00  00  00  00  00  00  00  00  00  00  00  00  00  00  00  00  00  00  00  00
00  00  00  00  00  00  00  00  00  00  00  00  00  00  00  00  00  00  00  00  00  00  00  00  00  00  00  00  00  00  00  00  00  00  00  00  00  00  00  00  00
00  00  00  00  00  00  00  00  00  00  00  00  00  00  00  00  00  00  00  00  00  00  00  00  00  00  00  00  00  00  00  00  00  00  00  00  00  00  00  00  00
00  00  00  00  00  00  00  00  00  00  00  00  00  00  00  00  00  00  00  00  00  00  00  00  00  00  00  00  00  00  00  00  00  00  00  00  00  00  00  00  005